1111111111111111111111111111111111111111111111111111111111111111111111111111111111
1111111111111111111111111111111111111111111111111111111111111111111111111111111111
1111111111111111111111111111111111111111111111111111111111111111111111111111111111
1111111111111111111111111111111111111111111111111111111111111111111111111111111111
1111111111111111111111111111111111111111111111111111111111111111111111111111111111
1111111111111111111111111111111111100000010000000000000000000000000011111111111111
1111111111111111111111111111111111101111010011111111111111110000011011111111111111
11111111111111111111111111111111111010000101110000000C0000101000101011111111111111
1111111111111111111111111111111111101011110110001111111100100101001011111111111111
11111111111111111111111111111111111010000101000X0000001110010000010011111111111111
1111111111111111111111111111111111101111010100111000011011010101011011111111111111
1111111111111111111111111111111111101000010100111000110001010010010011111111111111
11111111111111111111111111111111111A1011110100101110110001010000010111111111111111
1111111111111111111111111111111111101000S10100100110000001001101111111111111111111
1111111111111111111111111111111111101111111100100000011001100100000011111111111111
1111111111111111111111111111111111100000000000100011011101100111111011111111111111
1111111111111111111111111111111111111111111110100011000111110000001011111111111111
1111111111111111111111111111111111111111100000110110000011111011001011111111111111
1111111111111111111111111111111111111111101100011100000100000100101011111111111111
1111111111111111111111111111111111111111100010001111111100000000001011111111111111
1111111111111111111111111111111111111111100B10100100010111011111111011111111111111
1111111111111111111111111111111111111111111110100001000010000000000011111111111111
1111111111111111111111111111111111111111111111111111111111111111111111111111111111
1111111111111111111111111111111111111111111111111111111111111111111111111111111111