11111111111111111111111111111111111111111111111111111111111111111111111111111111
11111111111111111111111111111111111111111111111111111111111111111111111111111111
11111111111111111111111111111111111111111111111111111111111111111111111111111111
11111111111111111111111111111111111111111111111111111111111111111111111111111111
11111111111111111111111111111111111111111111111111111111111111111111111111111111
11111111111111111111111111111111100000011111111111111111111111111111111111111111
11111111111111111111111111111111101111011110000000C00011111111111111111111111111
11111111111111111111111111111111101000011000111111111011111111111111111111111111
11111111111111111111111111111111101011111010111111111001111111111111111111111111
11111111111111111111111111111111101000011010111111111101111111111111111111111111
11111111111111111111111111111111101111011010111111111101111111111111111111111111
111111111111111111111111111111111A1000011010111111111101111111111111111111111111
11111111111111111111111111111111101011111010111111111100111111111111111111111111
11111111111111111111111111111111101000S11010111111111110111111111111111111111111
11111111111111111111111111111111101111111000111111111110011111111111111111111111
11111111111111111111111111111111100000000000111111111000000000111111111111111111
11111111111111111111111111111111111111111110111111111001111110111111111111111111
111111111111111111111111111111111111111000001111111100D1111110111111111111111111
11111111111111111111111111111111111111101100011111110000000000111111111111111111
1111111111111111111111111111111111111110C010001111111111111111111111111111111111
11111111111111111111111111111111111111100010100100010111111111111111111111111111
11111111111111111111111111111111111111111110100001000B11111111111111111111111111
11111111111111111111111111111111111111111111111111111111111111111111111111111111
11111111111111111111111111111111111111111111111111111111111111111111111111111111