11111111111111111111111111111111111111111111111111111111111111111111111111111111
11111111111111111111111111111111111111111111111111111111111111111111111111111111
11111111111111111111111111111111111111111111111111111111111111111111111111111111
11111111111111111111111111111111111111111111110111111111111111111111111111111111
11111111111111111111111111111111111111111111110111111111111111111111111111111111
11111111111111111111111111111111111111111111110111111111100001111111111111111111
11111111111111111111111111111111111111111111110010000011101101111111111111111111
1111111101101110111B11001010C1E1000100000000000010111010101101111111111111111111
111111110100010001000100000001010101010000111000101G1010101101111111111111111111
1111111100010001000100011111010101010100101010101010001010L101111111111111111111
111111110011101110111100000001010101F1001110111010111110111101111111111111111111
111111110001000100011100100D0101010101001110111010000000000001111111111111111111
11111111010101010101110010000101010101001110111011111110111101111111111111111111
11000000000100010001111111111100010001000000000000000000000001111111111111111111
11A11111111111111111111111111111111111111111111111111111111111111111111111111111
11011111111111111111111111111111111111111111111111111111111111111111111111111111
11011111111111111111111111111111111111111111111111111111111111111111111111111111
11011111111111111111111111111111111111111111111111111111111111111111111111111111
11011111111111111111111111111111111111111111111111111111111111111111111111111111
11011111111111111111111111111111111111111111111111111111111111111111111111111111
11011111111111111111111111111111111111111111111111111111111111111111111111111111
11S11111111111111111111111111111111111111111111111111111111111111111111111111111
11111111111111111111111111111111111111111111111111111111111111111111111111111111
11111111111111111111111111111111111111111111111111111111111111111111111111111111
